000000000000000000000000
0**********00**********0
0*00000000000000000000*0
0*00000000****00000000*0
0*0*0000000000000000*0*0
100*0000000000000000*000
000*0000000000000000*002
0*0*0000000000000000*0*0
0*00000000****00000000*0
0*00000000000000000000*0
0**********00**********0
000000000000000000000000