00*000*00000*0**00*00000
00***0****00*00*00*00000
000000000000**000******0
0***0******00*0*00*00000
0*000*0000**0*0*0000*0**
0**00*0**00*000*0**0***0
00*10*00*00*****00*02000
*0000000*0**000**0*00*00
00*00****0*00*0*00*00*0*
0**0000000****0*0**00*00
00**0****00000000000**00
*0000000000********00000