0000*000*000000*000*0000
0**0000000*00*0000000**0
00**00000**00**00000**00
000000**00000000**000000
00000**000*00*000**00000
10*000000*0000*000000*00
00*000000*0000*000000*02
00000**000*00*000**00000
000000**00000000**000000
00**00000**00**00000**00
0**0000000*00*0000000**0
0000*000*000000*000*0000