10*00***000**000***00*00
00*000000*0000*000000*00
0**0*0****0000****0*0**0
0000*0000*0000*0000*0000
00***0000**00**0000***00
*000000*00000000*000000*
*000000*00000000*000000*
00***0000**00**0000***00
0000*0000*0000*0000*0000
0**0*0****0000****0*0**0
00*000000*0000*000000*00
00*00***000**000***00*02