10*000000000000000000*00
00*0*0****0**0****0*0*00
0****0*00*000000**0****0
000000*0000000*00*000000
0******00******00******0
00000*000*00000000*00000
00*00000000000*000000*00
0******00******00******0
000000*00*0000000*000000
0****0**000000*00*0****0
00*0*0****0**0****0*0*00
00*000000000000000000*02