10000*0*0000*00**0*0*0*0
****000*0*0***0000000000
000*0*0*0*000*00*0*****0
0*000*000*0*0*0**0*00000
0*0*********0000*0*00***
0*000000000*0**0****0000
0********00*0*00*0*00**0
0*0000*000**0**000000*00
0000*0*000000*00*0******
0*0**0***0****0**0000*20
0*00*000*000*000**0*0**0
0*00*0*000*000*0*00*0000