000000000000000000000000
0*00*00*00*00*00*00*00*0
000000000000000000000000
000000000000000000000000
1*00*00*00*00*00*00*00*0
000000000000000000000000
000000000000000000000000
0*00*00*00*00*00*00*00*2
000000000000000000000000
000000000000000000000000
0*00*00*00*00*00*00*00*0
000000000000000000000000